################################
#                              #
#                              #
##                             #
######                        ##
############         x         #
###########                 # ##
########                    #  #
###                    #       #
#######                  #  #  #
#######      ###               #
######       #####             #
######       #########         #
######      #####              #
#######      ######            #
#######         ##             #
#######         ##             #
##########                     #
# #############                #
#  ############                #
#   ##########                 #
#    #########                 #
#     ########                 #
#      #######                 #
#       ######                 #
#        #                     #
#                              #
#                              #
#           ##                 #
#            #                 #
#                              #
################################
